ABIGAIL	AE B AH G EY L
ADALYN	AE D AH L AH N
AIDEN	EY D EH N
ALEXANDER	AE L IH G Z AE N D ER
AMELIA	AH M IY L Y AH
ARIA	AA R IY AH
ATRAS	AA T R AA Z
AUBREY	AO B R IY
AVA	EY V AH
AVERY	EY V ER IY
BITACORA        B IH T AA K UH R AH
BENJAMIN	B EH N JH AH M AH N
BORRAR	B UH R AA R
BUSCAR	B UW S K AA R
CADEN	K EY D AH N
CALEB	K EY L AH B
CARTER	K AA R T ER
CHARLOTTE	SH AA R L AH T
CHLOE	K L OW IY
COLGAR	K OW L G AA R
CONTACTO	K UH N T AA K T OW
CONTACTOS	K UH N T AA K T OW Z
DANIEL	D AE N Y AH L
ELIJAH	EH L AY JH AH
ELIJAH(2)	IY L AY JH AH
EMILY	EH M IH L IY
EMMA	EH M AH
ETHAN	IY TH AH N
EVELYN	EH V AH L AH N
EVELYN(2)	EH V AH L IH N
GRAYSON	G R EY S AH N
HARPER	HH AA R P ER
ISABELLA	IH Z AH B EH L AH
JACK	JH AE K
JACKSON	JH AE K S AH N
JACOB	JH EY K AH B
JAMES	JH EY M Z
JAYDEN	JH EY D AH N
KAYLEE	K EY L IY IY
LAYLA	L EY L AA
LIAM	L IY AH M
LILY	L IH L IY
LISTO	L IY S T UH
LLAMAR	JH AH M AH R
LOGAN	L OW G AH N
LUCAS	L UW K AH S
LUKE	L UW K
MADELYN	M AE D IH L IH N
MADELYN(2)	M AE D L IH N
MADISON	M AE D AH S AH N
MADISON(2)	M AE D IH S AH N
MANDAR	M AA N D AA R
MASON	M EY S AH N
MENSAJE	M EH N S AA HH EY
MIA	M IY AH
MICHAEL	M AY K AH L
MODIFICAR	M UH D IH F IH K AA R
NOAH	N OW AH
NUEVO	N UW IY V OW
OLIVER	AA L AH V ER
OLIVER(2)	AA L IH V ER
OLIVIA	OW L IH V IY AH
PASSWORD	P AE S W ER D
RILEY	R AY L IY
RYAN	R AY AH N
SALIR	S AA L IH R
SOPHIA	S OW F IY AH
USERNAME	Y UW S ER N EY M
VIDEOLLAMADA	V IH D IY OW JH AH M AH D AH
WILLIAM	W IH L Y AH M
ZOE	Z OW IY
